WWWWWWWWWWWWWWWW
WEEEEEEEEEEEEEEW
WEEEEEEEEEEEEEEW
WEEEEEEEEEEEEEEW
WEEEEEEEEEEEEEEW
WEEEEEEEEEEEEEEW
WEEEWWWWWWEEEEEW
WEEEEEEEEEEEEEEW
WEEEEEEEEEEEEEEW
WEEEEEEEEEEEEEEW
WEEEEEEEEEEEEEEW
WEEEEEEEEEEEEEEW
WEEEEEEEEEEEEEEW
WEEEEEEEEEEEEEEW
WSEEEEEEEEEEEEEW
WWWWWWWWWWWWWWWW